           +!+                        |
            | |                       |
            | |                       |
         +--+ +--+                    |
         |       |                    |
         +--+ +--+                    |
            | |                       |
            | |                       |
        +---+ ++---+---+  +-+--!--!--!|
   +!+  |              |  |           |
   | |  |              |  | +--!--!--!|
   | |  |              |  | |         |
+--+ +--+              +--+ +--!--!--!|
|   p                       |         |
+--+ +--+              +--+ +         |
   | |  |              |  | |         |
   | |  |              |  | |         |
   +!+  |              |  | |         |
        +---+ ++---+---+--+ +-+       |
            | |         |     |       |
            | |         +-+ +-+       |
         +--+ +--+        | |         |
         |       |        | |         |
         +--+ +--+        +/+         |
            | |                       |
            | |                       |
            +!+                       |