+!-+-+---+-+-!+     |
|p            |     |
+!-+ +---+ +-!+     |
   | |   | |        |
   | |+++| |        |
   |   e   |        |
   | |+++| |        |
+--+ +---+ +--+     |
|             |     |
+--+ +---+ +--+     |
   | |   | |        |
   | |   | +!!+!!+  |
   | |   |       |  |
 +-+ +--++-+!!+!!+  |
 |     |            |
 |  +  +--+--+--+---+
 |  +               |
 |  +  +--+-+  +--+ +
 |     |    |  |  | |
 +-+-+-+    |  |  | |
   +--+--+--+  +  | |
   |           |  | |
   | +--+--+---+  +/+
   | |              |
+!-+ +-+-!+         |
|         |         |
| +--+--+ |         |
|         |         |
+!+--!--+!+         |