+!-+--+-+--+--+-+-+--+-+
!               |      |
+!-+--+ +--+--+ + +--+ |
      | |     | | |  | |
      | |     | | |  | |
+!-+--+ |     | | | ++ |
!p      |     | | | !  |
+!-+--+ |     +-+ | ++ |
      | |       | |  | |
      | |       | |  | |
+!-+--+ +--+-+--+ | ++ |
!                 | !  |
+!-+--+ +--+ +--+-+ ++ |
      |      |       | |
      +-+--+-+       | |
                    ++ |
                    !  |
                    ++ |
                     | |
                     +/+